X XXXXXXXXXXXXXXXXXXXXXXXXXXXXXXXXXXXXXXXXXXXXXXXXXXXXXXXXXXXXXXXXXXXXXXX
X       X       X     X     X         X X   X   X   X     X   X         X
XXX XXXXX XXX XXX XXX X XXX X XXX XXX X X X X X X X X XXX X X X XXXXX XXX
X   X     X X X   X   X X     X X   X X   X   X X X   X X   X   X   X   X
X XXX X XXX X X XXX XXX X XXXXX XXX X XXXXXXX X XXXXXXX XXXXXXXXX X XXX X
X X   X     X X   X     X       X   X   X X   X       X   X       X X   X
X X XXXXXXXXX XXX XXXXXXXXXXXXXXX XXXXX X X XXXXXXX X XXX X XXXXXXX X X X
X     X X     X           X   X   X X     X     X   X     X   X   X X X X
X XXX X X XXX XXXXXXXXXXXXX X X XXX X XXXXXXXXX X XXXXXXX XXX X XXX X X X
X   X   X   X       X     X X   X   X X       X X     X   X   X     X X X
XXXXXXXXXXX XXXXXXX X XXX X XXXXX XXX XXX XXX X XXXXX XXXXX XXXXX XXX XXX
X       X   X   X   X X X X         X   X   X   X X         X   X   X   X
X X XXX X XXXXX X XXX X X XXX XXXXX XXX XXXXX XXX X XXXXXXXXX X XXXXX X X
X X   X         X     X X     X       X         X X     X   X X X   X X X
X XXXXXXXXXXXXXXXXXXXXX XXXXX XXXXXXXXXXXXXXXXX X XXXXX X X X X X X X X X
X     X         X X   X X   X X     X       X X       X X X   X   X   X X
XXXXX XXX XXX X X X X X X X X X XXX X XXXXX X XXXXXXX X XXX XXXXXXXXXXX X
X     X   X   X     X   X X   X X     X     X   X   X X   X X         X X
X XXXXX XXXXXXXXXXXXXXXXXXXXXXX XXXXXXX XXXXXXX X X X XXX XXX X XXXXX X X
X X     X     X   X           X   X   X   X   X   X X   X X   X     X   X
X XXX XXX XXX X X X XXXXXXX X XXX X XXXXX X XXXXX X XXX X X XXXXXXX XXXXX
X   X   X X   X X X       X X   X X   X X   X   X X X X X     X   X X   X
XXX XXX X XXXXX X X XXXXX X XXX X X X X XXX X X X X X X XXXXX X X X XXX X
X       X X     X   X X   X   X X   X     X X X X X X X X   X   X X   X X
X XXXXX X X XXXXXXXXX X XXXXXXX XXXXXXXXX X X X X X X X X X X XXXXX X X X
X X   X X   X           X     X           X   X X X     X X X X   X X   X
X XXX XXXXXXX XXXXXXXXXXX XXX XXXXXXXXXXXXXXXXX XXXXXXXXX X XXX X X XXXXX
X   X         X X   X   X X X         X       X   X       X X   X   X   X
X X XXXXX XXXXX X X XXX X X X XXX XXXXX X XXXXX X X XXXXXXX X XXXXXXX X X
X X     X       X X     X X X X   X   X X     X X X   X   X X         X X
XXXXXXX XXXXXXX X XXXXXXX X X X XXX X XXX XXX X X XXX X X X XXXXXXXXXXX X
X       X         X   X   X   X     X   X X     X     X X   X X     X   X
X XXXXXXXXXXXXXXXXXXX X XXXXXXXXX XXXXX XXX XXXXXXXXXXX XXXXX X XXX X XXX
X                 X   X X   X   X     X     X     X   X       X X   X   X
XXXXXXX XXXXXXXXX X XXX X X X X XXXXXXXXXXXXX X XXX X XXX XXXXX X XXXXX X
X     X   X     X X   X   X   X         X   X X     X   X     X X X X   X
X XXX XXX X XXXXX XXX X XXXXXXXXXXXXX X XXX X XXXXXXXXX XXXXX X X X X X X
X   X X   X       X   X X       X   X X       X     X   X   X   X X X X X
XXX X XXXXX XXXXXXX XXXXX XXX X X X X XXXXXXXXXXXXX X X XXX XXXXX X X X X
X   X     X     X   X X   X   X X X X X   X   X   X   X   X     X   X X X
X XXXXXXX XXXXX X XXX X XXX XXX XXX X X X X X X X XXXXXXX X XXXXXXX X X X
X X           X     X   X X X     X X   X X X   X         X X     X X X X
X XXXXXXXXXXXXXXXXX X XXX X XXXXX X XXXXX X XXXXXXXXXXXXXXX X XXX XXX X X
X   X         X     X X   X     X X   X   X   X X         X     X   X X X
X X X XXXXXXX X XXXXX X X XXX X XXX X X XXXXX X X XXXXX X XXXXXXXXX X X X
X X   X         X     X X     X     X       X     X     X             X X
XXXXXXXXXXXXXXXXXXXXXXXXXXXXXXXXXXXXXXXXXXXXXXXXXXXXXXXXXXXXXXXXXXXXXXX X
